---------------------------------------
---------------------------------------
---------------------------------------
---------------------------------------
---------------------------------------
---------------------------------------
---------------------------------------
---------------------------------------
---------------------------------------
---------------------------------------
---------------------------------------
-------------------------B-------------
---------------------------------------
--------P------------------------------
---------------------------------------
-#####################################-
---------------------------------------
---------------------------------------
