-------------------------------------------------------------------------------
-------------------------------------------------------------------------------
-------------------------------------------------------------------------------
-------------------------------------------------------------------------------
-------------------------------------------------------------------------------
----------------##########-----------------------------------------------------
-------------------------------------------------------------------------------
-------------------------------------------------------------------------------
-------------------------------------------------------------------------------
-------------------------------############------------------------------------
-#-----------------------------------------------------------------------------
-#---###########---------B----------------------############-------------------
-#--------------------#######--------------------------------------------------
-#------P----------------------------------------------------------------------
-#-----------------------------------------------------------------------------
-#############################################################################-
-------------------------------------------------------------------------------
-------------------------------------------------------------------------------
