----------------------------------------------------------------
----------------------------------------------------------------
----------------------------------------------------------------
----------------------------------------------------------------
----------------------------------------------------------------
----------------##########--------------------------------------
----------------------------------------------------------------
----------------------------------------------------------------
----------------------------------------------------------------
-------------------------------############---------------------
-#------------------------------------------------------------#-
-#---###########--------------------B-----------############--#-
-#--------------------#######---------------------------------#-
-#------P-----------------------------------------------------#-
-#------------------------------------------------------------#-
-##############################################################-
----------------------------------------------------------------
