-------------------------------------------------
-------------------------------------------------
-------------------------------------------------
-------------------------------------------------
-------------------------------------------------
--------------1------------------------2---------
-------------------------------------------------
-------------------------------------------------
-------------------------------------------------
-###############################################-
-------------------------------------------------
-------------------------------------------------
