-----------------------------------------------------------
-----------------------------------------------------------
-----------------------------------------------------------
-----------------------------------------------------------
-----------------------------------------------------------
-----------------------------------------------------------
-----------------------------------------------------------
-----------------------------------------------------------
-----------------------------------------------------------
-----------------------------------------------------------
-----------------------------------------------------------
-----------------------------------------------------------
-----------------------------------------------------------
------------------------------------------------------B----
-------P---------------------------------------------------
-----------------------------------------------------------
-----------------------------------------------------------
-#########################################################-
-----------------------------------------------------------
-----------------------------------------------------------
