-------------------------------------------------------------------
-------------------------------------------------------------------
-------------------------------------------------------------------
-------------------------------------------------------------------
-------------------------------------------------------------------
-------------------------------------------------------------------
------------------------------------------------------#####--------
-------------------------------------------------------------------
------------------------------------------------###----------------
------------------##########---------------------------------------
-------------------------------------------------------------------
----------------------------------------#####----------------------
-------------------------------------------------------B-----------
-------------------------------------------------------------------
--------------------------------------------#####################--
----------------------------------------------------------------#--
------------------------######---------################---------#--
-----------------------##########-------------------------------#--
--P------------------###############----------------------------#--
--------------------#################---------------------------#--
##################################################################-
-------------------------------------------------------------------