-------------------------------------------------------------------------------
-------------------------------------------------------------------------------
-------------------------------------------------------------------------------
-------------------------------------------------------------------------------
-------------------------------------------------------------------------------
----------------##########-----------------------------------------------------
-------------------------------------------------------------------------------
-------------------------------------------------------------------------------
-------------------------------------------------------------------------------
-------------------------------############------------------------------------
-#-----------------------------------------------------------------------------
-#---###########---------E----------------------############-------------------
-#--------------------#######--------------------------------------------------
-#------P------------#########-------------------------------------------------
-#------------------############-----------------------------------------------
-#############################################################################-
-------------------------------------------------------------------------------
-------------------------------------------------------------------------------
