-------------------------------------------------
-------------------------------------------------
-------------------------------------------------
-------------------------------------------------
-------------------------------------------------
-------------------------------------------------
-------------------------------------------------
-------------------------------------------------
-------------------------------------------------
-------------------------------------------------
-#------------B--------------------------------#-
-#----###-------------------#----------E-------#-
-#------------####-----###--#------------------#-
-#------P-------------------#------------------#-
-#--------------------------#------------------#-
-###############################################-
-------------------------------------------------
-------------------------------------------------
