-----------------------------------------------------------
-----------------------------------------------------------
-----------------------------------------------------------
-----------------------------------------------------------
-----------------------------------------------------------
-----------------------------------------------------------
-----------------------------------------------------------
-----------------------------------------------------------
-----------------------------------------------------------
-----------------------------------------------------------
-----------------------------------------------------------
-----------------------------------------------------------
----------------E------------------------------------------
-----------------------------------------------------------
-------P---------------------------------------------------
-----------------------------------------------------------
-----------------------------------------------------------
-#########################################################-
-----------------------------------------------------------
-----------------------------------------------------------
