-------------------------------------------------
-------------------------------------------------
-------------------------------------------------
-------------------------------------------------
-------------------------------------------------
-----------------1---------------------2---------
-------------------------------------------------
-------------------------------------------------
-------------------------------------------------
-###############################################-
-------------------------------------------------
-------------------------------------------------
