---------------------------------------------------------------------------------
---------------------------------------------------------------------------------
---------------------------------------------------------------------------------
---------------------------------------------------------------------------------
---------------------------------------------------------------------------------
---------------------------------------------------------------------------------
---------------------------------------------------------------------------------
---------------------------------------------------------------------------------
#--------------------------------------------------------------------------------
#-----2-------------------1------------------------------------------------------
#--------------------------------------------------------------------------------
#################################################################################
---------------------------------------------------------------------------------
