-----------------------------------------------------------------------------
-----------------------------------------------------------------------------
-----------------------------------------------------------------------------
-----------------------------------------------------------------------------
-----------------------------------------------------------------------------
-----------------------------------------------------------------------------
-----------------------------------------------------------------------------
-----------------------------------------------------------------------------
-----------------------------------------------------------------------------
-----------------------------------------------------------------------------
-#----------------------------------------B--------------------------------#-
-#----###-----------------------------------------------#----------E-------#-
-#----------------------------------------####-----###--#------------------#-
-#------P-----------------------------------------------#------------------#-
-#------------------------------------------------------#------------------#-
-###########################################################################-
-----------------------------------------------------------------------------
-----------------------------------------------------------------------------
