--------------------------------------------------------------
--------------------------------------------------------------
--------------------------------------------------------------
--------------------------------------------------------------
--------------------------------------------------------------
--------------------------------------------------------------
--------------------------------------------------------------
--------------------------------------------------------------
--------------------------------------------------------------
-------------------#--------------------------#---------------
-------------------#--------------------------#---------------
-------------------#--------------------------#---------------
-------------------#--------------------------#---------------
-------------------#----###-------------------#---------------
-------------------#------------####-----2----#---------------
-------------------#------1-------------------#---------------
-------------------#--------------------------#---------------
-############################################################-
--------------------------------------------------------------
