-----------------------------------------------
-----------------------------------------------
-----------------------------------------------
-----------------------------------------------
-----------------------------------------------
-----------------------------------------------
-----------------------------------------------
-----------------------------------------------
-----------------------------------------------
-------------------#--------------------------#
-------------------#--------------------------#
-------------------#--------------------------#
-------------------#--------------------------#
-------------------#----###-------------------#
-------------------#------------####-----2----#
-------------------#------1-------------------#
-------------------#--------------------------#
-------------------############################
-----------------------------------------------
