-----------------------------------------------------------
-----------------------------------------------------------
-----------------------------------------------------------
-----------------------------------------------------------
-----------------------------------------------------------
-----------------------------------------------------------
-----------------------------------------------------------
-----------------------------------------------------------
-----------------------------------------------------------
-----------------------------------------------------------
-----------------------------------------------------------
-#----------------------------------###########--------#---
-#--------------E--------------------------------------#---
-#--------------######---------#############-----------#---
-#-----P-------##########------------------------------#---
-#-----------###############---------------------------#---
-#----------#################--------------------------#---
-#########################################################-
-----------------------------------------------------------
-----------------------------------------------------------
